 1  1  1  1  1  1 1  1
12 19 21  1 22 20 5 18
 5 14  7  5 10 15 5 17
 4  8  7 13 10 11 4 16
 1  2  6  4  9  3 1  1
 1  1  1  1  1  1 1  1
