5 14 5 12 5 5 15 5
5 14 5 5 13 5 15 5
4 8 5 5 5 5 11 4
1 2 6 4 4 9 3 1 
1 1 1 1 1 1 1 1
1 1 1 1 1 1 1 1