5 14 7 12 5 10 15 5
5 14 7 5 13 10 15 5
4 8 7 5 5 10 11 4
1 2 6 4 4 9 3 1 
1 1 1 1 1 1 1 1
1 1 1 1 1 1 1 1