7 7 7 8 13 14 7 7 
7 7 7 8 11 12 7 7
0 0 0 0 0 0 0 0
1 1 1 1 4 1 1 1
2 2 2 2 5 2 2 2
3 3 3 3 6 3 3 3