9 9 17 15 11 8 13 15
9 9 16 14 10 7 12 14
0 0  0  0  0 0  0  0
1 1  1  1  4 1  1  1
2 2  2  2  5 2  2  2
3 3  3  3  6 3  3  3